********XXXX
XXXXXXX*X***
XXXXXXX***X*
XXXXX**XXX**
XXXXXXXXXX**