********
XXXX*XXX
******XX
*XX**X**
XXXX*XX*
********
XXXXX***
XXXXXXX*