*#*##*****#*******##*#******#*******#***#*#***********#****#*#****#********#********#*#*#***#*****#*
*#****#*#*#*#*#*#******##*#*#*#*###*#*#*****###*#*#*#*##*##****##**#*#*#*##**#*####*******#**#*##*#*
*#*###*#**#*#**######*#****#**#***#*#*##*##*#**#***#***#*#**#*#**##**#**#***#*#****###*#*#*#***#****
**#******#**##**#****#*#*###*#*##**#****#**#**#**##**#*#***##***#***#*#*#*##****#*#***#**#*#########
#**#*#*#*#*#**#*#*##****#****#***#**###**#***#**##**##**#*##*##***##**#*#*###*#**#**#**#*******#****
*#*#**#*#****#**#**#*##*##*##*#*###****#**#*#*#***##***#*******##*#**#**#**#***#*#*###**######***##*
*#**#*****##*#*###**#*#****#*****#*###*##*#***#*#***##*#*#####*#**#*#**#*#**##**#***#**#******####**
**#**#*#*##*#***###*#*#####*####*****#**#***#**####*#***#*****#**#**#*#***#**##**##*#*#**##*#*#****#
*#*#*#**#*****#**#**#***********#*#*#*#**###*#**#***#*#*##*##**#***##**##**#**#*#***#***#****##*###*
***#*##*#*#*##*#**#**#*#*##*###**#****#*##*****#**##*##**#*#*#*#*#***#****###*#***##**#*#*#*#***#***
*#*#***##**#****#**#**#****#**##*#*###**#**####**#*#***#***#***##*###**#*#*##**####**###**#*#*##**#*
**#*##***#***#*#*#**#*##*#**#******#***#**#*****#***##***###*#*******#*#*****#*#***##*#**##*#*#**#**
#*****##**###**#**#*#***###**##*#*#**#*#*#**##*#**#****##***#**#####*#**###*##*#*#*#***#***##***#**#
**#*#***#***#*###****##*####***#**#*##*#**#**#**##*####***#**##****#**##****#**#*#***#*#*#*#*###**##
*#**#*#*###*#*###*###*#**##**#*#*#**#**##**#*#*#******#*####***#*#**#**#*#*##*##**###**##*******#*##
*#*##**#****#**#**#****#***#*#**#**#*#**##*#*##**##*#*#***#*##**#**###*#**#******#***#****###*#*#**#
*#***##**#####*#*#**#*#*##*#*#*#**#***#**#*#**#*#**#***#*#***##*#*#*##**#*#*###*#*##**#*##**##***#**
*#*#**#*#***#**##*#*#****#*#*#**#***#**#*#*##*#**#**#*#**#*#****#*****#*#*****##***##**#**#****#**#*
**###***#*#***#*****###*#**##**#*#####*#*#**#**#*##*#*##*#**#*##**#*#****####**#*#***#**#***#*#*##**
#**#*###***#*#**####****#*#***#*****#***#**#*#******#****#*#*#***#*#*###*****#*#**#*###***##*#*****#
*#*****###**#**#*****##*#**#*#*#*#*#**##**#***#*#*##*####**#*#*##******###*#*##*#*#**#**###***##*#*#
**##*#****#**#**#*#*#****#*#******#**#***#**#**#********#*#**#*##*##*##***##******##**###***#**#*#**
*##*#*#*#**#***##**#*#*#*#**#*###**#**#*#**#**#**#*#*##*#*#*##****#*#***#***##*###**#*#***##**#**##*
*******#**#**##***#***###*#*#***##**#***#*##*#**#*#*#***#*#***#*##****##*##***#***#*****##*#*#**#***
#*###*##*#*###**#*#*#**#****##*#***#####**#**##*#****###***##****#*#*#*****##*#*#*####*#***#*#*##*##
*****#***#****#**##*#*#**#*#**#**#*##**#*##*#***#*##****##*##*####**#*#*##**#***#*****#*##*****#**#*
*##*##*##*#*#**#****#**#*##*#***#*****#**#***#*##*#*###*#****#****#***#*###*#####*#*#*#***#*###*#*#*
#***#**##****#*#*#*#*#********##**##*#**#**#**#***#*****#*##***##**##*#**###*****####*#*#**#**#*#*#*
**#*#*#***##*#**#*****#*#*###**#*#*##**#*#**#***##**####**#*#*#**#*##**#**#**#*#**#***#**#*##***#*#*
#**#**##*#****#**##*#*##*#***##**#****#***####*#**#*#****#***#*#*#***#**#*#*#**##***##*#*#***##***#*
*#**#***#*##*#*#**#**#*****#***#**#*##**#***#***#****#*#*#*#***#**#*#**#**#**#***##*#****###*###*#**
*##**##*#****#***#**#**#######**#*#*#**#*##*#*###*##**#***#**#*#*#***#***#*#*##*#***#*###**#**#***#*
****#*#***###**##**#**#****#***#**#*#*##**#**#***#*#*#**#*#*##***#*#*#*##**#***#**###****#**#*#*#***
#*#****####**#**#*#**#**##*#*##**#**#***#**#***#*#***#*#**#*#*##**##******###*#**#***#*#**#*#**#**#*
***##*#*****#*#**#**#**###*#*#**#**#**#**#**###**###**#**#**#***#***#####**#**#*###*###**#***#*#*#*#
#*#***#*#*#*#**#***#**#*#**#**####***###***#***#****#*##***#**#**##*#***#*#**#***#***#**#**#*#*#*#**
***#*#**#*#***#####**#***#**#***#**#*##*#*#**#*#*##*#***###**#**##**#*#*#*#*##*#***#*#*#**#*#**#*##*
*#**#**##**##**#***#***#**#**##*#*##****###*#**#*#**###****#**##***##*#*#*#***##*#*##****#**#*##**#*
**#***##*#*#*#*#*#**#*###**#**#*##***###****#*#*#**#***###*##****##***#*#**##*#***#***#*#*#***#*#***
#**####**#*#*#**#*#****#**###*#***#*#****#*#**#***#**#***#***###*#**###**###***#*#**#**#***#*#***##*
*#*#****#**#**#****####**#*#**###**#**###*#**#**#***#*##*#*#****##*#***#****##**##*#*##**#*#**##**#*
*#***##*#*#*#**##*#*****#****#***#***#**#***#*##**##***#**#*###*#**#*##*###*#**#***#**#*##***#***#**
*####***#*#***###***###*#*#####*#*###*#***##****#***#*#*#*#*****#*##****#***#*#**##*#*#***###**#**#*
*****#*#**###**#**##***#**#**#******#**#*#**#*#*###***#*#*##*#*#****##*#**##****##****#*#***##**##**
*#*#***##***##**##***###*#**#**##*#**#*#**#***#****##***#***##**#*#*#***#***#*##***##**#*##***#****#
**#*###*###***#****#*****##**#**#*#*##**#***#**#*#**###**##*#*#**#***##**#*#*****##**#*#***##**#*#*#
#*#***#****##*####*#*#*##**#**#*#*#****#*###*##*#*#****#*#**#**#**##***#***###*##*##*#**#*#**#*###**
#**#*#**##**#*****#***#***#*#***#*#####************###**#**#**#*#***#*##*##***#****#***#****##****##
*#****#***#**#*##*#*#*#*#****##*#*******###*#*#*#*#***#***#**#***##*#*#**#**#*#*##***###*##***###***
**###**#*#*#**#*#*#*#**#**##***#**#*#*###**#**#**##*#**#*#*#***##*#***##***#**##*#*#*#*****#*#***##*
#***#*#**#**#***#**#*#*###*#*#**##*#*****#*#*#**#****#**##*#*#*****###**#*###*****#**#*##*#*#**#*#**
**###**#*#*#*##**#*#*#*******##*****##*#***#*#*#**##**#****#*#*###****#**#*#*##*#*##***#****#*#**#*#
#****#*#*#***#**#**#**#*#####**####*#***#*#***#**#**#**#*#*#**#***##*#*#******#*#***##*######*#*##**
**#*#**#***#*#*#*#**#**#****#*#***#**###*#**##**##*#*#*#*#**#**#*#*#***##*#*#**#*##*#*#*******#***#*
*##**#*####*#*****#**#*#*#*#****#**#*#*****###*#******##**#**#*#****#*#****#*#***#**#***#*#*##*##*#*
***#*#********##*#**#****#***###*#*#*#*#*#**#**#*#*#*#***#*##**##*##**#*##****##*#*#**##*###****#***
*#*#*###*##*##**#**###*##*#*#******#*#*##**#**#**#**#**#*#***#*****#*#****#*#**###***##***#**#*#**#*
*#*#******##***#**#*#**#***###*#*#*#*#***##**#**#*#**#*##**#*####*##***####**#****####**#**#*#**##**
#**###*##**#*#***#****##*#**#**#**#**#*#***#*##***#*##****#*****#***##*#***#**###*****##*#**#**#***#
**#***#***#**##*#**###****#*#*#**#**#***##*#**#*##****#*#*#####***#***#**#*#*##***#*#****##***#**##*
*#**#*#*##**#**#*#***#*#*##*#**##**#**#**#*##*#***###**#*#*****###*#*#**#***#***##*#*###***#*##*#***
#**#**##***###****#*#***#****#****#**#*###****###****#***#*#*#******#**#**#***##*#*****###***#**#*#*
**#*#***##**#**#*##**####*#*#*#*##**#*****#*#***#*##**####**#######**#*##**###****#*#*#****##**#**#*
*#***##***#*#*#**#*#*#****#*#*##***#**###**#*##*#***#*#***#**#*****#*#***##****##*#*###*#*#***#**##*
*##*#**#*#**#*#*#****#*###**#****##**#***#*#**#*#*#*#***#**#*#*###*#*#*#****###***#******##*#*#*#***
**#***##**#*#*#*#*###**#***######***#**#****#****#***#####*#*****#*#*#**###*#***##**#*#*#***##**#*#*
#*#*#***#*#**#****#**#*#*#**#****##**#**#*##*###**##*#**#***###*#**#*###***#**##***#*#*#**##***#*#**
**#**####*##*#*###*#***##*#***##*#**#*#**#******#*#****##*#****#**#******#***#*##*#****#*#**#*#**#*#
#*##*********#*#****#*#****#*#***#*#**##***####*#*#*#*#***###*##*#**#*###**###*****##*##*#*#***#****
#***##*######***#*#****#*#**#**##***#**#####**#*#*#**##*##***#****##*#***##***####**#*#**#*#*#*####*
**#***#*****#*#*#**###*#*#*#**##*##**#*******##*#**##***#**#***#*#*****#****#****#*#**#*##***#*****#
#**##*#*###*##***###***#*#*#*#******#**##*###****#*#**#**#**#*#**#*##*#*####*#*#*#***#****####*#*#*#
*#*#**#***#***##*****##***##**#*#####*###*#***###****####**#*#**##***##****#**#**####**##*****#**#**
***#*#*#*####***#*#*##**#*#*#*#*#******#**#*##****#*#*#***#**#*##*##***#*#***#**#****#*#*##*#**#**#*
*###***#**#**##**###***#****#*#**#*#####*#**#**#*#*#****##**#*****#*##**###*#**#**##**#****#*#**###*
#****#**#*#*#**#**#**##*##*#**##*##******#*#*##****#*#*#**#**####*#*#*#**#***#***#**#***###***#*#***
**#####*#*#***#*#*#*##***#***#*****#*#*#*#*#****##*#**#*#**#****#*#****#***##*###*#*###***#*#*#***#*
#****#*##***#***#*#*#**#**#*#*#*##*#**##*#**#*##****#****#***#*##**#*##*##********#***###***#**###**
#*##*****###*##*#**#**#*#*#****#****#*#***#**##**##**##*#**##**#*#*#******##*##*#**##****#*#*#****#*
**#*####******#**#***#**#**#*#***####**##**#*#**##*#*#***#*#*#*****#*##*#***#****#***#*#*###***#*##*
*#******#*#*##**#*###*#*##*##*#*#****#**###**#*#****#**##**#**#######***#*#*#*##*###***##***#*#**#**
*#*##*#**##**#*##********#*****#**##**#*****#*#**##**#*#**#**##****#**##***##*###***###***#**#**#**#
**###*#*#***#**#**######**####**#**##**#*##*#***##*#*#*#*#**##**#*#**#**#*#****#**#***#*#**#*#*###**
#**#***#**##**#*#******##****#*##*#***#****#**#*#**#***#**#****#****#*#***#*###**#*##*#**##*****#*#*
*#***#*#*##**#****####***##*##****#*##**##**###*#*#*###*#**#*##*##*#****###*#***#***#**#*#**#*##**#*
**#*#**#****##*###****#*#***#*##*##***##**#*****#*****#***#**#***#**###*#***#*##*#*#**#**####****#**
#**#**####*#***#*#*#*#*#**##****#**##***#**#######*##*#*##*#***#*#*#***#**#*#*##***##*#*#****#*#*#*#
*#***#*#**#*#*#**#*#****#****##**#***##**#******#**##*#**#***#*#*#*#*#***#*##***##******#*##*##**#**
*#*##***#***#***##**###*###*#**#**#*#*#*#**##*#*#*#****#*#*##*#**#*#*#*##****##*#**##*#*#**#***#**#*
*#*#*##***#**##***#*#*#*****#*#*#*#***#*#*#***#*#**#*###**#*****#*#***##**##*#***#***###**#*##*#*#**
*#*****##**#***#*#**#*##*#*#**#*#**#*#**#*##*#***#*#*#***#**#*#***#*##***#***#*#*#*#**#**#***#**#**#
**####***#*###****#*#***#*#*#***#*#***#**#***#*#***#*#*##**#*#*#*#***#*##*##**#***#*#**#*#*##*#*##**
#*#***##*#***####*#**##******#*#****##**#**##***###**#***#*#***#**#*#**#****#***##***##**#****#****#
****##*#*###****#**#***#*#*#***#*#*#***#*#**####***#*#*##**##*###*#**#*#*##**##*#**#**#*##*##**####*
#*#****#***##*#**##*##*#**##*#*#**#**##****#*****#**#*****#***##***#*#***#*#*#**#*#*#*#*#**#**#*****
***##*####**#*#*#******#*#***#*#*#**##**##***#*#**#*#*##*#*#*#***##**#*##**#*#*#**#*#*#**###*##*#*#*
*#**#**#**#**#**#*#*####*#*##**#**#*#**######**##*#*****#******##*#*#*##*#*#*#*#*#**#**#*****#**#*#*
*#*#*#***#*#*#*#***#*****#**#*#**#**#*#*##***#**###*####**####****#*#****#*#*#*#***###*#*#*#**#*#*#*
#****###******#**##**#*##*#**#*#*#*#*#*****#*###***#****###***####***#*#***#**#**#**##**##*##**##*#*
**##****#*#*#***#***#******#*****#*****#*#*#*****#***##*****#******#***#*#**#***###***#******#****#*
